6 2 4 8 7 6 0 1 4 5
1 5 2 8 1 6 1 0 8 4
3 6 6 0 1 5 2 7 0 3
6 7 6 7 6 7 6 7 6 7
5 1 0 1 4 8 2 6 1 3
7 8 0 1 4 0 1 0 5 7
1 5 1 0 0 6 8 3 6 2
8 6 3 0 2 4 6 1 7 4
2 5 8 5 2 7 8 4 8 0
1 5 7 3 8 3 7 5 1 0
0 1 5 7 3 8 3 2 6 3
0 4 6 2 1 3 9 4 2 1
8 0 6 4 2 1 6 2 8 3
1 6 4 0 3 1 6 3 2 6
7 5 8 1 3 6 0 5 1 4
7 1 5 6 0 1 7 8 3 2