0 2 8 6 1 7 4
8 6 0 2 7 1 4
2 0 6 8 1 7 4
6 8 2 0 7 1 4
0 8 6 2 3 5 4
8 0 2 6 5 3 4
2 6 8 0 3 5 4
6 2 0 8 5 3 4
0 6 2 8 7 3 4
8 2 6 0 1 5 4
2 8 0 6 7 3 4
6 0 8 2 1 5 4
0 2 6 8 3 7 4
8 6 2 0 5 1 4
2 0 8 6 3 7 4
6 8 0 2 5 1 4