0 1 2 3 4 5 6 7 8 1
8 7 6 5 4 3 2 1 0 3
6 3 0 1 2 5 8 7 6 3
1 4 7 8 5 2 1 4 7 8
0 3 6 7 8 5 2 1 0 4
0 4 8 7 6 3 0 1 2 5
6 4 2 5 8 7 6 4 2 5
4 3 0 1 2 5 8 7 6 4
5 4 3 0 1 2 5 8 7 6
2 1 0 3 4 5 6 7 8 0
5 2 1 0 3 4 5 4 3 0
0 1 0 1 8 7 6 7 6 3
4 7 4 7 5 8 0 1 2 1
6 0 1 2 3 6 7 8 3 4
0 6 7 8 5 2 3 4 6 7
1 7 6 8 5 2 0 1 3 4