0 4 8 6 8 2 0 5 3
2 4 7 5 1 0 1 0 6
7 4 1 7 0 8 4 2 6
6 2 7 4 1 0 8 6 2
4 1 6 0 3 2 0 7 3
5 2 8 4 1 5 2 3 6
1 4 2 6 2 8 1 0 3
8 4 1 7 2 0 6 1 5
7 4 0 1 4 1 0 6 3
5 1 0 5 8 5 1 3 5
7 1 2 4 0 6 4 1 4
8 4 1 4 2 0 6 2 1
8 4 1 6 2 0 3 1 4
1 4 2 1 0 6 4 1 8
2 4 7 1 0 8 4 1 0
6 1 4 0 7 2 4 6 8 