0 2 8 6 3 5
8 6 0 2 5 3
2 0 6 8 3 5
6 8 2 0 5 3
0 6 2 8 5 3
8 2 6 0 3 5
0 8 6 2 1 7
8 0 2 6 7 1
2 6 8 0 1 7
6 2 0 8 7 1
0 2 6 8 7 5
8 6 2 0 1 3
2 8 0 6 5 1
6 0 8 2 3 7
0 6 8 2 4 5
8 2 0 6 4 3