0 1 2 8 6
1 2 3 7 5
2 3 4 0 8
3 4 5 1 7
4 5 6 2 0
5 6 7 3 1
6 7 8 4 2
7 8 0 5 3
0 1 4 8 6
1 2 5 7 3
2 3 6 0 8
3 4 7 1 5
4 5 8 2 0
5 6 0 3 7
6 7 1 4 2
7 8 2 5 0
