0 1 2 3 4 8 6 2
1 2 3 4 5 7 3 0
2 3 4 5 6 0 8 4
3 4 5 6 7 1 2 8
4 5 6 7 8 2 0 3
5 6 7 8 0 3 1 4
6 7 8 0 1 4 2 5
7 8 0 1 2 5 3 6
0 1 2 4 5 8 6 3
1 2 3 5 6 7 0 4
2 3 4 6 7 0 8 5
3 4 5 7 8 1 2 6
4 5 6 8 0 2 1 7
5 6 7 0 1 3 2 8
6 7 8 1 2 4 3 0
7 8 0 2 3 5 4 1