0 1 2 3 4 5 6 7 8
8 7 6 5 4 3 2 1 0
0 2 4 6 8 1 3 5 7
8 6 4 2 0 7 5 3 1
0 3 6 1 4 7 2 5 8
8 5 2 7 4 1 6 3 0
0 4 8 2 6 3 7 1 5
8 4 0 6 2 5 1 7 3
0 1 3 5 7 8 6 4 2
8 7 5 3 1 0 2 4 6
2 4 6 8 0 7 5 3 1
6 4 2 0 8 1 3 5 7
0 5 2 7 4 1 6 3 8
8 3 6 1 4 7 2 5 0
1 4 7 0 3 6 8 5 2
7 4 1 8 5 2 0 3 6