0 8 2 6 4
8 0 6 2 4
2 6 0 8 4
6 2 8 0 4
0 4 8 2 6
8 4 0 6 2
2 4 6 0 8
6 4 2 8 0
0 6 4 2 8
8 2 4 6 0
2 8 4 0 6
6 0 4 8 2
0 2 4 8 6
8 6 4 0 2
2 0 4 6 8
6 8 4 2 0