0 1 2 3 8 6 4
1 2 3 4 7 5 0
2 3 4 5 0 8 6
3 4 5 6 1 7 2
4 5 6 7 2 0 8
5 6 7 8 3 1 4
6 7 8 0 4 2 5
7 8 0 1 5 3 6
0 1 3 4 8 6 2
1 2 4 5 7 3 0
2 3 5 6 0 8 4
3 4 6 7 1 5 2
4 5 7 8 2 0 6
5 6 8 0 3 1 4
6 7 0 2 4 1 8
7 8 1 3 5 2 0