0 2 8 6 1 7 3 5
8 6 0 2 7 1 5 3
2 0 6 8 3 5 1 7
6 8 2 0 5 3 7 1
0 8 2 6 4 1 7 3
8 0 6 2 4 7 1 5
2 6 0 8 4 3 5 1
6 2 8 0 4 5 3 7
0 6 8 2 1 5 7 3
8 2 0 6 7 3 1 5
2 8 6 0 3 7 5 1
6 0 2 8 5 1 3 7
0 4 8 2 6 1 7 3
8 4 0 6 2 7 1 5
2 4 6 0 8 3 5 7
6 4 2 8 0 5 3 1